0000000000000000000000000
0000000000000000000000000
0000000000000000000000000
0000000000000000000000000
0000000000000000000000000
0000000000000000000000000
0000000000000000000000000
0000000031111111000000000
0000000000000000000000000
0000000000000000000000000
0000000000000000000000000
0000000000000000000000000
0000000000000000000000000
0000000000000000000000000
0000000000000000000000000

0000000000000000000000000
0000000000000000000000000
0000000000000111111100000
0000011111111100000100000
0000010000000100000100000
0000010011111100000100000
0000010010001111100100000
0000010010001000111100000
0000010010001000110000000
0000010011111111110000000
0000010000110000010000000
0000010000300000010000000
0000011111111111110000000
0000000000000000000000000
0000000000000000000000000

0000000000000000000000000
0000000000000000000000000
0000000000000000000000000
0000000030000000000000000
0000000010111100000000000
0000000011101111000000000
0000000111111111000000000
0000111111000001000000000
0000101111011111000000000
0000111111010000000000000
0000000001011100000000000
0000000001111100000000000
0000000000011000000000000
0000000000000000000000000
0000000000000000000000000

0000000000000000000000000
0000000000000000000000000
0000003000000000000000000
0000111000000000000000000
0000111111110000000000000
0000001001110111111000000
0000001101000100001000000
0000000101110111101100000
0000000101110011100100000
0000000111110011101100000
0000000010011110001000000
0000000011000000111000000
0000000001111111100000000
0000000000000000000000000
0000000000000000000000000

0000000000000000000000000
0000000000000000000000000
0000000000000000000000000
0000000000000000300000000
0000000001111111110000000
0000000001101101110000000
0000000001101101110000000
0000000111111111110000000
0000000110111111000000000
0000000111000001000000000
0000000111111111100000000
0000000000001111100000000
0000000000000000000000000
0000000000000000000000000
0000000000000000000000000

0000000000000000000000000
0000000000000000000000000
0000000000000000000000000
0000000000000000011000000
0000000000000000011000000
0000000000011111111000000
0000000000110000111000000
0000000011131100111000000
0000000011000101111000000
0000011111111111011000000
0000010111001110011000000
0000011101111000000000000
0000000000000000000000000
0000000000000000000000000
0000000000000000000000000

0000000000000000000000000
0000000000000000000000000
0000000000110000000000000
0000000000111000000000000
0000000000111110000000000
0000000111111110000000000
0000011111000010110000000
0000110000000011110000000
0000131110000000011000000
0000111111111111011000000
0000000001110001110000000
0000000000000001100000000
0000000000000000000000000
0000000000000000000000000
0000000000000000000000000

0000000000000000000000000
0000000000000000000000000
0000011100000000011100000
0000010100300011110100000
0000010111111110011100000
0000110110011111011000000
0001100111110111111000000
0001100111110111000000000
0000100000010011000000000
0001100111110011000000000
0001111101100011000000000
0000000000111110000000000
0000000000111110000000000
0000000000000000000000000
0000000000000000000000000